33,-1,-1,-1,-1,-1, Bullet can pierce
-5,0,5,500,0,0
0,434,383,54,0,1
289,384,94,50,0,1
385,515,577,6,2000000001,0
434,386,204,28,0,1
706,386,188,28,0,1
960,386,94,126,0,1
1054,449,97,63,0,1
1150,515,629,6,2000000001,0
1207,257,48,46,0,0
1216,418,14,65,0,1
1230,418,24,28,0,1
1254,414,42,18,0,1,1
1280,408,52,16,0,1,1
1299,403,50,13,0,1,1
1316,399,48,9,0,1,1
1332,395,49,8,0,1,1
1348,391,39,6,0,1,1
1372,386,66,28,0,1,1
1488,386,87,28,0,1
1575,390,23,24,0,1
1598,395,22,19,0,1
1620,400,19,14,0,1
1639,407,26,9,0,1
1665,412,24,9,0,1
1689,417,37,29,0,1
1776,450,111,61,0,1
1887,417,190,94,0,1
2176,261,158,155,0,0
2143,417,191,124,0,1
1893,511,184,248,0,1
2304,541,156,48,0,0
2077,706,480,61,0,1